AD=右耳
AS=左耳
AU=兩耳
BUCC=口頰
ENEM=灌腸
EPID=硬脊膜外腔注射
GARG=漱口
IA=動脈注射
ID=皮內注射
IDF=經透析液
IL=病灶內注射
IM=肌肉注射
IMP=植入
INHA=吸入
IP=腹腔內注射
IRRI=灌洗
IS=關節內注射
ISB=雙側關節內注射
ISL=左關節內注射
ISR=右關節內注射
IT=脊椎注射
ITV=玻璃體內注射
IV=靜脈注射
IVD=靜脈間歇性輸注
IVE=膀胱灌注
IVF=靜脈持續性輸注
LOC=局部注射
NASA=鼻噴劑
OD=右眼
OS=左眼
OTHE=其他
OU=兩眼
PO=口服
RECT=肛門用
SC=皮下注射
SL=舌下
SPRA=局部噴劑
SUB=舌下
TEST=動脈注射TESTTEST
TOPI=局部使用
VAG=陰道塞劑
WETT=敷傷口